10 10 100 0
####D#####
#     #  # 
###  !++ # 
#@@   @@ #
#  ##### #
#/   @@ !#
#@#@@    # 
#       !# 
#    #@@@#
##########
