10 30 0 0
###########D##################
# !                     !    #
#         !                  #
#@@@@@@@@@@@       &&        #
#          @                 #
#  +       @     &           #
#          @        +++      #
#       /  @                 #
#          @    +            #
##############################

















